NO ./textures/brick-wall_.xpm
SO ./textures/brick-wall_.xpm
EA ./textures/brick-wall_.xpm
WE ./textures/brick-wall_.xpm




EN ./resources/nextbots/Obunga.xpm



C 171, 199, 216   
F 186, 128, 74

1111111111111111111111111111111111111111111111111111
1000000000000000000000000000000000000000000000000001
1E00000000000000000000000000000000000000000000000001
1000111000100010011111001111100110001100111110000001
1001000000100010010001000010000101010100100010000001
1010000000111110011111000010000100100100111110000001
1010000000100010010001000010000100000100100010000001
1001000000100010010001000010000100000100100010000001
1000111000100010010001001111100100000100100010000001
1000000000000000000000000000000000000000000000000001
1000000000000000000000000000000000000000000000000001
1000000000000000000000000000000000000000000000000001
1000000000000000000000000000000000000000000000000001
1111111111111111111111111111111111111111111111111111