      NO ./textures/NO.xpm
EA ./textures/EA.xpm
		C 0,0,0
        SO ./textures/SO.xpm
	WE ./textures/WE.xpm


F 44, 110,73
      

 
1111111111111111111111111
1000000000110000000000001
1011000001110000000000001
100100000000000000000000111111111
 111111111011000001110000000000001
100000000011000001110111111111111
11110111111111011100000010001
11110111111111011101010010001
11000000110101011100000010001
111111100000000001100000010001
       100000N0000000001101010111111
    1111100111011101111101111111111
11110111 1110101 101111010001
11111111 1111111 111111111111