NO ./textures/messi.xpm
SO ./textures/messi.xpm
EA ./textures/brick-wall_.xpm
WE ./textures/brick-wall_.xpm




C 0,0,0 
F 0,0,0



11111111111111111111
10000000000000000001
10000000000000000001
10000000000000000001
100000X0000000000001
100000N0000000000001
10000000000000000001
11111111111111111111
