NO ./textures/messi.xpm
SO ./textures/SO.xpm
EA ./textures/brick-wall_.xpm
WE ./textures/WE.xpm




C 171, 199, 216   
F 186, 128, 74



11111111111111111111111111111111
10000000000000000000000000000001
10000000000000000000000X00000001
10000000000000000000000000000001
10000000000000000000000000000001
10000000000000000000000000000001
10000000000000000000000000000001
10000000000000000000000000000001
10000000000000000000000000000001
10000000000000000000000000000001
10000000000000000000000000000001
10000000000000000000000000000001
10000000000000000000000000000001
10000000000000000000000000000001
10000000000000000000000000000001
10000000000000000000000000000001
10000000000000000000000000000001
10000000000000000000000000000001
10000000000000000000000000000001
10000000000000000000000000000001
10000000000000000000000000000001
10000000000000000000000000000001
10000000000000000000000000000001
10000000000N00000000000000000001
10000000000000000000000000000001
11111111111111111111111111111111
