      NO ./textures/brick-wall_.xpm
EA ./textures/EA.xpm




C 0  ,  0     ,0   
	WE ./textures/WE.xpm

        SO ./textures/SO.xpm





F 44,110,73



11111111111111111111111111111111111111
10000000000000000000000000000000000001
10000000000000000000000000000000000001
11111000000000000000000000000000000001
    1000000000000000000000000000000001
11111000000000000000000000000000000001
10000000000000001000000000000000000001
10000000000000000000000000000000000001
10000000000000000000000000000000000001
1000000000000000N000000000000000000001
10000000000000000000000000000000000001
10000000000000000000000000000000000001
10000000000000000000000000000000000001
10000000000000000000000000000000000001
10000000000000000000000000000000000001
10000000000000000000000000000000000001
10000000000000000000000000000000000001
10000000000000000000000000000000000001
10000000000000000000000000000000000001
10000000000000000000000000000000000001
10000000000000000000000000000000000001
10000000000000000000000000000000000001
10000000000000000000000000000000000001
11111111111111111111111111111111111111
