      NO ./textures/NO.xpm
EA ./textures/EA.xpm
        SO ./textures/SO.xpm
	WE ./textures/WE.xpm
		C 0,0,0




F 44,110,73
1111111
1000001
100N001
1000001
1111111
