NO ./textures/brick-wall_.xpm
SO ./textures/brick-wall_.xpm
EA ./textures/brick-wall_.xpm
WE ./textures/brick-wall_.xpm




EN ./resources/nextbots/Obunga.xpm



C 171, 199, 216   
F 186, 128, 74



11111111111111111111111111111111
10000000000000000000000000000001
10000000000000000000000000000001
1000000000000000000000D000000001
10000000000000000000000000000001
10000000000000000000000000000001
1000000000S000000000000000000001
10000001D1D100000000010000000001
10000001D100000000000D0000000001
10000000000000000000010000000001
10000000000000000000000000000001
10000000000000000000000000000001
10000000000000000000000000000001
10000000000000000000000000000001
10000000000000000000000000000001
10000000000000000000000000000001
11111111111111111111111111111111

