      NO ./textures/NO.xpm
EA ./textures/EA.xpm
        SO ./textures/SO.xpm
	WE ./textures/WE.xpm
		C 0,0,0




F 44,110,73

111111
1W0001
100001
100001
100001
111111
