NO ./textures/messi.xpm
SO ./textures/SO.xpm
EA ./textures/brick-wall_.xpm
WE ./textures/WE.xpm




   EN ./resources/nextbots/messi_4.xpm



C 171, 199, 216   
F 186, 128, 74



11111111111111111111111111111111
1E0000000000000000000000000000X1
10000000000111111111100000000001
10000000000000000000000000000001
10000000001000000000000000000001
10000000001000000000001000000001
10000000001000000000000000000001
11111110001000000000000000000001
10000000001000000000111111100001
10000000001000000000000000000001
10000000001000000000000000000001
10000000001000000000000100000001
10000000001000000000000100000001
10000000000000000000000100000001
10000000000000000000000100000001
10000001111111111110000100000001
10000000000000000000000100000001
10000000100000000000000000000001
10000000100000000000000000000001
10000000000000000000000111111111
10000000000000000000000000000001
10000000000000000000000000000001
11111111111111111111111111111111

