      NO ./textures/NO.xpm
EA ./textures/EA.xpm
        SO ./textures/SO.xpm
	WE ./textures/WE.xpm
		C 0,0,0




F 44,110,73

1111111111111111111111111
1000000000000000000000001
1000000000000100000000001
1000N00000000000000000001
1000000000000000000000001
1000000000000000000000001
1111111111111111111111111
