    WE ./textures/redbrick.xpm    

    SO ./textures/redbrick.xpm    

        EA  ./textures/redbrick.xpm      
EN  ./resources/nextbots/chinwi.xpm              
F   186       ,   128, 74  
        
    NO   ./textures/redbrick.xpm  







        C    171,       199, 216            


111111111111111111
1000000000000000E1
100000000000000001
100000000000000001
100000000000000001
100000000000000001
100000000000000001
100000000000000001
100000000000000001
100000000000000001
100000000000000001
100000000000000001
100000000000000001
100000000000000001
100000000000000001
100000000000000001
100000000000000001
100000000000000001
100000000000000001
100000000000000001
100000000000000001
100000000000000001
100000000000000001
100000000000000001
100000000000000001
100000000000000001
100000000000000001
1111111111D111111
100000000000011
1001000X000100111
10100000000010001
11111111111111111
