NO ./textures/simonkraft/soul_sand.xpm
SO ./textures/simonkraft/warped_nylium.xpm
EA ./textures/simonkraft/respawn_anchor_side1.xpm
WE ./textures/simonkraft/netherrack.xpm




EN ./resources/nextbots/messi_4.xpm



C 171, 199, 216   
F 186, 128, 74





11111111111111111
1N000000000000X01
10000000000000001
10000000000000001
10000000000000001
10000000000000001
10000001000000001
10000000000000001
10000000000000001
10000000000000001
10000000000000001
10000000000000001
11111111111111111
