NO ./textures/test/north.xpm
SO ./textures/test/south.xpm
EA ./textures/test/east.xpm
WE ./textures/test/west.xpm




EN ./resources/nextbots/coach.xpm



C 171, 199, 216   
F 186, 128, 74





11111111111111111
1W000000000000X01
10000000000000001
10000000000000001
10000000000000001
10000000000000001
10000000000000001
10000000000000001
10000000000000001
10000000000000001
10000000000000001
10000000000000001
11111111111111111
