NO ./textures/brick-wall_.xpm
SO ./textures/brick-wall_.xpm
EA ./textures/brick-wall_.xpm
WE ./textures/brick-wall_.xpm




EN ./resources/nextbots/Obunga.xpm



C 171, 199, 216   
F 186, 128, 74

11111111111111111111111111111111
10000000000000000001000000000001
1000000000000000000D000000000001
10000000001000000001000000000001
10000000000000000001111111111111
10000000000000000000000000000001
100000000000S0000000000000000001
10000000000000000000000000000001
100000000001D1000000000000000001
100000000001D1000000000000000001
100000000001D1000000000000000001
100000000001D1000000000000000001
100000000001D1000000000000000001
100000011111D1111000000000000001
1000000D0001X1000100000000000001
10000001000010000010000000000001
11111111111111111111111111111111

