NO ./textures/brick-wall_.xpm
SO ./textures/brick-wall_.xpm
EN ./resources/nextbots/Obunga.xpm
EA ./textures/brick-wall_.xpm
WE ./textures/brick-wall_.xpm







C 171, 199, 216   
F 186, 128, 74





 1
1D11111111111
10100000001
10000N001111
100000000X01
111111111111