NO ./textures/redbrick.xpm
SO ./textures/redbrick.xpm
EA ./textures/redbrick.xpm
WE ./textures/redbrick.xpm




EN ./resources/nextbots/coach.xpm



C 171, 199, 216   
F 186, 128, 74





11111111111111111
1W000000000000001
10000000000000001
10000000000000001
10000000000000001
10000000000000001
10000000000000001
10000000000000001
10000000000000001
10000000000000001
1000X000000000001
10000000000000001
11111111111111111
