NO ./textures/brick-wall_.xpm
SO ./textures/brick-wall_.xpm
EN ./resources/nextbots/Obunga.xpm
EA ./textures/brick-wall_.xpm
WE ./textures/brick-wall_.xpm







C 171, 199, 216   
F 186, 128, 74

11111111111111111111111111111111111111111111
100000000000000000000000000000000000000000001
1000000000000000000000000000000000000000001011111111111111
10000000000000000000000000000000111111111110000000DDDDD001
1000000000000000000000000000000000000000001D11111111111111
100000000000000000000000000000000000000000001
100000000000000000000000000000000000000000001
100000000000000000000000000000000000000000001
100000000000000000000000000000000000000000001
11111111111110000000000000000000000000000001
100000000000100000000000000000000000000000001
10000X000000100000000000000000000000000110111111111111111111
100011101100100000000000000000000000000100000000000D00000001
100010000101100000000000000000000000000111111111111111111111
10001000000110000000000000000000000000000001
10011111101110100000000000000000000000000011
100100000000000010000000000000000000000000001
1111D1111111111111111111111111111111111111111
   101
   1011111111111
   10111111100001111111111111111
   1000000D0D11D0001111111111111
   1N11111111111111111111111111
    1   