NO ./textures/brick-wall_.xpm
SO ./textures/brick-wall_.xpm
EA ./textures/brick-wall_.xpm
WE ./textures/brick-wall_.xpm




EN ./resources/nextbots/Obunga.xpm



C 171, 199, 216   
F 186, 128, 74

11111111111111111111111111111111
1000000000000000S0000000D0000001
1000X000000000000000000010000001
11111111111111111D11111111111111
10000000000000000000000000000001
10000000000000000000000000000001
11111111111111111111111111111111

